DDDDDDDDDDDDDDDDDDDDDDDDDDDDDDDDDDD
D                                 S
D                K    K    K      S
D            DD DDD  DDD  DDDDDDDDD
D   DD  DD                        D
D                                 D
DD      PP              PP    KKKPD
D   DD      PP D  D  D  DD  DDDDDDD
D       DD                        D
D           DD     K              D
D               DDDDDD            D
D                                 D
D             PP        DDDDDDDDDDD
D             KK    DD            D
D           DDDDDD                D
D         D                       D
D       D                         D
D  P  D                           D
D  K                              D
DWWWWWWWWWWWWWWWWWWWWWWWWWWWWWWWWWD