DDDDDDDDDDDDDDDDDDDDDDDDDDDDDDDDDDD
D              C   CC   CC        S
D                K    K    K      S
D            DD DDD  DDD  DDDDDDDDD
D   DD  DD                        D
D                                 D
DD      CC              CC    KKKCD
D   DD      CC   DD  D  DD  DDDDDDD
D       DD                        D
D           DD     K              D
D               DDDDDD            D
D                                 D
D             CC        DDDDDDDDDDD
D             KK    DD            D
D           DDDDDD                D
D         D                       D
D       D                         D
D  C  D                           D
DP K  KKKKKKKKKKKKKKKKKKKKKKKKKKKKD
DWWWWWWWWWWWWWWWWWWWWWWWWWWWWWWWWWD