D                                 S
D              C   CC   CC        S
D                K    K    K      S
D           DDD DDD  DDD  DDDDDDDDD
D   DD  DD                        D
D                                 D
DD      CC              CC      KCD
D   DD      CC          DD  DDDDDDD
D       DD                        D
D           DD  DDDDDD            D
D                                 D
D             CC        DDDDDDDDDDD
D            K  K                 D
D           DDDDDD  DDD           D
D         D                       D
D       D                         D
D  C  D                           D
DP    KKKKKKKKKKKKKKKKKKKKKKKKKKKKD
DWWWWWWWWWWWWWWWWWWWWWWWWWWWWWWWWWD