NNNNNNNNNNNNNNNNNNNNNNNNNNNNNNNNNNN                                 N                                 N
                    NNNNNNNNNN   CN
          K    K                  N
NNNNNNN  NNN  NNN  NNNNNNNNNNNN   N
N                 PP          PP  N
N              KK    KK    KK     N
N             NNNN  NNNNNNNNNN  NNN
N          NN                     N
N       NN                        N
N    NN                           N
N                                 N
N                                 N
N                                 N
N                                 N
N                                 N
N                                 N
N                                 S
N                                 S
NKKKKKKKKKKKKKKKKKKKKKKKKKKKKKKKKKN
NMMMMMMMMMMMMMMMMMMMMMMMMMMMMMMMMMN